#domain
hospital
#levelname
MAExample
#colors
red: 0, A
green: 1, B
#initial
++++++++++++
+        + +
+ ++++++++B+
+0        1+
+A++++++++ +
+ +        +
++++++++++++
#goal
++++++++++++
+        +B+
+ ++++++++ +
+          +
+ ++++++++ +
+A+        +
++++++++++++
#end
