#domain
hospital
#levelname
MAmultiagentSort
#colors
blue: 0, 1, 2, 3, A, B, C, D, E, F, G, H, I, J, K, L, M, N, O, P, Q, R, S, T, U, V, W, X, Y, Z
#initial
+++++++++++++++++++++++++++++++++++++++++++++
+THE QUICK BROWN FOX JUMPS OVER THE LAZY DOG+
+   0                    2                  +
+             1                     3       +
+                                           +
+++++++++++++++++++++++++++++++++++++++++++++
#goal
+++++++++++++++++++++++++++++++++++++++++++++
+                                           +
+                                           +
+                                           +
+ABCDEEEFGHHIJKLMNOOOOPQRRSTTUUVWXZY        +
+++++++++++++++++++++++++++++++++++++++++++++
#end